###########################
#   #######################
# # #######################
# #                       #
# ####################### #
# #   #   #   #   #   ###B#
# # # # # # # # # # # # # #
# # # # # # # # # # # # # #
#A  #   #   #   #   #     #
###########################